             @@           @@@@@@      @@@@@@         @@@@@@@
     @@      @@         @@      @@  @@      @@     @@@@@@@@@@@
     @@      @@  @@     @@      @@  @@      @@    @@@@@@@@@@@@@
 @@@@@@@@@@  @@@@@@@@@  @@      @@  @@      @@    @@@@@@@@@@@@@
     @@          @@     @@      @@  @@      @@     @@@@@@@@@@@
     @@          @@       @@@@@@      @@@@@@         @@@@@@@


