                @@@@       @@@@@@      @@@@@@         @@@@@@@
     @@       @@    @@   @@      @@  @@      @@     @@@@@@@@@@@
     @@           @@     @@      @@  @@      @@    @@@@@@@@@@@@@
 @@@@@@@@@@     @@       @@      @@  @@      @@    @@@@@@@@@@@@@
     @@       @@         @@      @@  @@      @@     @@@@@@@@@@@
     @@       @@@@@@@@     @@@@@@      @@@@@@         @@@@@@@


