                @@      @@@@@@      @@@@@@         @@@@@@@
     @@       @@@@    @@      @@  @@      @@     @@@@@@@@@@@
     @@         @@    @@      @@  @@      @@    @@@@@@@@@@@@@
 @@@@@@@@@@     @@    @@      @@  @@      @@    @@@@@@@@@@@@@
     @@         @@    @@      @@  @@      @@     @@@@@@@@@@@
     @@       @@@@@@    @@@@@@      @@@@@@         @@@@@@@


